HWKbd	KEYWORD1
hwKeyboard	KEYWORD1
HWKbd_Encoder	KEYWORD1
hwEncoder	KEYWORD1
isConnected	KEYWORD2
modeLEDsEnabled	KEYWORD2
setKeysOnScan	KEYWORD2
pinKBD_reset	KEYWORD2
pinKBD_clock	KEYWORD2
pinKBD_read	KEYWORD2
pinLED_reset	KEYWORD2
pinLED_clock	KEYWORD2
connect	KEYWORD2
setLEDs	KEYWORD2
setMode	KEYWORD2
scan	KEYWORD2
input	KEYWORD2
HWKBD_DEBUG_	LITERAL1
HWKBD_TYPEMATIC_DELAY	LITERAL1
HWKBD_BUTTON_REPEAT	LITERAL2
HWKBD_FAST_PORTS	LITERAL1
HWKBD_PULSE_LEN	LITERAL1
HWKBD_BUFFER_SIZE	LITERAL1
HWKBD_LAST_BUTTON	LITERAL1
HWKBD_LAST_CODEPAGE	LITERAL1
